18.ox
.o.oo...o...o.....
...........o..o...
..o........o...o..
.....oo....o.....o
............o...o.
....o..........o..
.....o....oo.o..oo
..o..o.o.oo.o.....
.oo......o.o....o.
...o.o........o..o
ooo.....oo..oo..oo
..ooo...o....o.o..
..o..........o....
o.o.o..o..........
o....o.o..........
.o...o.o....o.....
o....o.....oo.o...
....o.....ooo.....
